################################
#   # # #    #       #   # #   #
# ##  #   ### ## ###   ###   ###
# ## #### ##   #   ###     #   #
# ## ## #    ### #   # ### #####
#    #  ## ## ## ####### ###  ##
## # # ### #   #         # # # #
## # #     ###   ########  # # #
## ## # # #   # ###     ##   # #
##  # # # ### # #   #####  ### #
## ##   # # #    ## # ## #     #
#  ## #  ## ## #    #  # # #####
# # # # # #  # #### ## # # ## ##
# # # ### # ## # ##  #   #  #  #
# # #     # #      #### ###   ##
#   # ### #   ######  #     # ##
# # #   ### #   #    #### # #  #
# ### #  #  ####  ### # # # ####
# # # ##### # ## #    #   #   ##
#   # # ##  #    ####  ## ###  #
# #   #    ## ###     ### # ####
# ### # ####      ### ##      ##
# # # #      ### ######  # ### #
# # # ## ## ########    ##   # #
# # # ## #           ###### #  #
# #      # # # #####      # # ##
# # ## # ##### #   # ## ##### ##
##   # #      ## # #  # ##     #
#  # # # ## #    #### #    #####
# ## # #   ## ##   #### ##     #
# #  # # # #   # #   #    # ## #
################################
