лллллллллллллллллллллллллллллллл
л   л л л    л       л   л л   л
л лл  л   ллл лл ллл   ллл   ллл
л лл лллл лл   л   ллл     л   л
л лл лл л    ллл л   л ллл ллллл
л    л  лл лл лл ллллллл ллл  лл
лл л л ллл л   л         л л л л
лл л л     ллл   лллллллл  л л л
лл лл л л л   л ллл     лл   л л
лл  л л л ллл л л   ллллл  ллл л
лл лл   л л л    лл л лл л     л
л  лл л  лл лл л    л  л л ллллл
л л л л л л  л лллл лл л л лл лл
л л л ллл л лл л лл  л   л  л  л
л л л     л л      лллл ллл   лл
л   л ллл л   лллллл  л     л лл
л л л   ллл л   л    лллл л л  л
л ллл л  л  лллл  ллл л л л лллл
л л л ллллл л лл л    л   л   лл
л   л л лл  л    лллл  лл ллл  л
л л   л    лл ллл     ллл л лллл
л ллл л лллл      ллл лл      лл
л л л л      ллл лллллл  л ллл л
л л л лл лл лллллллл    лл   л л
л л л лл л           лллллл л  л
л л      л л л ллллл      л л лл
л л лл л ллллл л   л лл ллллл лл
лл   л л      лл л л  л лл     л
л  л л л лл л    лллл л    ллллл
л лл л л   лл лл   лллл лл     л
л л  л л л л   л л   л    л лл л
лллллллллллллллллллллллллллллллл
