████████████████████████████████
█   █ █ █    █       █   █ █   █
█ ██  █   ███ ██ ███   ███   ███
█ ██ ████ ██   █   ███     █   █
█ ██ ██ █    ███ █   █ ███ █████
█    █  ██ ██ ██ ███████ ███  ██
██ █ █ ███ █   █         █ █ █ █
██ █ █     ███   ████████  █ █ █
██ ██ █ █ █   █ ███     ██   █ █
██  █ █ █ ███ █ █   █████  ███ █
██ ██   █ █ █    ██ █ ██ █     █
█  ██ █  ██ ██ █    █  █ █ █████
█ █ █ █ █ █  █ ████ ██ █ █ ██ ██
█ █ █ ███ █ ██ █ ██  █   █  █  █
█ █ █     █ █      ████ ███   ██
█   █ ███ █   ██████  █     █ ██
█ █ █   ███ █   █    ████ █ █  █
█ ███ █  █  ████  ███ █ █ █ ████
█ █ █ █████ █ ██ █    █   █   ██
█   █ █ ██  █    ████  ██ ███  █
█ █   █    ██ ███     ███ █ ████
█ ███ █ ████      ███ ██      ██
█ █ █ █      ███ ██████  █ ███ █
█ █ █ ██ ██ ████████    ██   █ █
█ █ █ ██ █           ██████ █  █
█ █      █ █ █ █████      █ █ ██
█ █ ██ █ █████ █   █ ██ █████ ██
██   █ █      ██ █ █  █ ██     █
█  █ █ █ ██ █    ████ █    █████
█ ██ █ █   ██ ██   ████ ██     █
█ █  █ █ █ █   █ █   █    █ ██ █
████████████████████████████████
