################################
#        #    #   ####         #
# # ## ### ### ##     #### #####
### ## #        # ####         #
# # ## ## ##### #      #### ####
# ## #  #   # # # #### # ##    #
# ## # ## #   ##     # # #  # ##
# ##   ## # ## # ### #   # ##  #
#    #  # #  # # # # # # #  # ##
# ## ## # #### # # ####### ## ##
# #####      #   # # # # ##    #
##      ## ##  # # # # # ##### #
##### #  #    ##   # # #  #  # #
#     ## # ##   #### # # ## ## #
#### ### # ####          #    ##
#    ##  #     #### # ##   ## ##
# ## #  ## #######  # ## #  #  #
# #  # ##       #  ##   ### ## #
# #### ## ### #### #  # #    # #
##   # #   #### ## # ## #### # #
#### # ###      # ###   #  ### #
#        #### #     # #   #    #
# # # ## #  # # ##### ## ## ## #
### ##     ## ###  ##########  #
# # #  ## ##### ##           ###
# # ## #    #      ###### ##   #
#    # # ##   #### # #  #  # # #
# #### ###  # # ## # ## ###### #
# #     #  #### #    #        ##
##  ### ##      # ##   # # #####
#  #     # ### ## #  # # #     #
################################
