████████████████████████████████
█        █    █   ████         █
█ █ ██ ███ ███ ██     ████ █████
███ ██ █        █ ████         █
█ █ ██ ██ █████ █      ████ ████
█ ██ █  █   █ █ █ ████ █ ██    █
█ ██ █ ██ █   ██     █ █ █  █ ██
█ ██   ██ █ ██ █ ███ █   █ ██  █
█    █  █ █  █ █ █ █ █ █ █  █ ██
█ ██ ██ █ ████ █ █ ███████ ██ ██
█ █████      █   █ █ █ █ ██    █
██      ██ ██  █ █ █ █ █ █████ █
█████ █  █    ██   █ █ █  █  █ █
█     ██ █ ██   ████ █ █ ██ ██ █
████ ███ █ ████          █    ██
█    ██  █     ████ █ ██   ██ ██
█ ██ █  ██ ███████  █ ██ █  █  █
█ █  █ ██       █  ██   ███ ██ █
█ ████ ██ ███ ████ █  █ █    █ █
██   █ █   ████ ██ █ ██ ████ █ █
████ █ ███      █ ███   █  ███ █
█        ████ █     █ █   █    █
█ █ █ ██ █  █ █ █████ ██ ██ ██ █
███ ██     ██ ███  ██████████  █
█ █ █  ██ █████ ██           ███
█ █ ██ █    █      ██████ ██   █
█    █ █ ██   ████ █ █  █  █ █ █
█ ████ ███  █ █ ██ █ ██ ██████ █
█ █     █  ████ █    █        ██
██  ███ ██      █ ██   █ █ █████
█  █     █ ███ ██ █  █ █ █     █
████████████████████████████████
