████████████████████████████████
█ █ ██        ██   █   █ █████ █
█ █ █ ███ █ █ █ ██ █ ███       █
█ █ █ █ █ █ █ █ ██ █    ████ ███
█ █ █ █ █████ █ ██ █ ██  █ █   █
█     █          █ █████   █ █ █
██ ██ ██ █ ███ ███ █   █ ███ █ █
██ ██ ████ █ █ █   █ █ █ ██   ██
█   ██ █ █ █   ██ ██ ███    █  █
█ █  █ █ ██ ██    █     ██ █████
█ ██     █    ███   ███ █      █
█ ██████ █ ████  █ ██ █ █ ██████
█ ██   █   █ █ █ ████   █ █    █
██  ██   █   █ █     ██   █ █ ██
█ █    █████ █  ████    █   █ ██
█ █ ████   █ ██ █ ██ ██ ████ █ █
█ █ █    █      █ █  ██   ██ █ █
█ █ ███ ███████   ████  █    █ █
█ ██ ██ █     █ █      ██ ██   █
█  █ █  █████ ██████ █  ████ █ █
██ █ ████       █    ██ █ █  █ █
█  █    ███████ █ ██ ██ █ █ ██ █
█ ██ ████ ██       █ █    ███  █
█            █████ █ █ ██  █  ██
█ ██████████  █ ██ █ ████ ██ ███
█ █ █ █     █    █ █    █ ██   █
█   █ █ █████ ██ ███████    ██ █
████           █  █   █  ██ ██ █
█    █ ████ ██  █ ███ ██ ██  █ █
██████  ███ ██ ██ █ █      █ ███
█      █     █   ██   ████ █   █
████████████████████████████████
