лллллллллллллллллллллллллллллллл
л        л    л   лллл         л
л л лл ллл ллл лл     лллл ллллл
ллл лл л        л лллл         л
л л лл лл ллллл л      лллл лллл
л лл л  л   л л л лллл л лл    л
л лл л лл л   лл     л л л  л лл
л лл   лл л лл л ллл л   л лл  л
л    л  л л  л л л л л л л  л лл
л лл лл л лллл л л ллллллл лл лл
л ллллл      л   л л л л лл    л
лл      лл лл  л л л л л ллллл л
ллллл л  л    лл   л л л  л  л л
л     лл л лл   лллл л л лл лл л
лллл ллл л лллл          л    лл
л    лл  л     лллл л лл   лл лл
л лл л  лл ллллллл  л лл л  л  л
л л  л лл       л  лл   ллл лл л
л лллл лл ллл лллл л  л л    л л
лл   л л   лллл лл л лл лллл л л
лллл л ллл      л ллл   л  ллл л
л        лллл л     л л   л    л
л л л лл л  л л ллллл лл лл лл л
ллл лл     лл ллл  лллллллллл  л
л л л  лл ллллл лл           ллл
л л лл л    л      лллллл лл   л
л    л л лл   лллл л л  л  л л л
л лллл ллл  л л лл л лл лллллл л
л л     л  лллл л    л        лл
лл  ллл лл      л лл   л л ллллл
л  л     л ллл лл л  л л л     л
лллллллллллллллллллллллллллллллл
