################################
# #     # # # # #      # #### ##
#   ##### #   #   # ####       #
# ##    # # # ### #  # # ## ## #
#    #### # # # # # ##    # ####
## ##   # # ###   #### ######  #
## ## ### # # ## #   #  #     ##
#             #  # ####   ###  #
# # ############ #      #   ####
# # ####     ###   #### # #    #
# #      ###     # #  # # ## # #
### ## #   ### # # ## # #  # # #
#   #  # ##  # ###    # #### # #
### ###  ## ##    ## ##   #   ##
#      #      # ######  # # #  #
## ### # ###### #    # ## # ####
#    # #      ### # ##### # #  #
# ## # ## ###   # # #    ## # ##
# ## # #    # #   ##  ## ##   ##
# ## ##  # ## # # ## ### #  #  #
# ## #  ##  # # #    #  ## ### #
##   ##   # ### ## # # ### # # #
#  # #  # # #   ## #     #   # #
#### # ## # # #  # #############
##   #  # # # # ## #   #       #
#  # ## # # # # ## # ##  #######
# ##  # # ### # ## # ## ##   # #
#  ## # #   # ###       ## ### #
## # ## # # #  #  #####     ## #
## # #  # ### ###     #####    #
#    ## #    #    # #      ## ##
################################
