лллллллллллллллллллллллллллллллл
л л     л л л л л      л лллл лл
л   ллллл л   л   л лллл       л
л лл    л л л ллл л  л л лл лл л
л    лллл л л л л л лл    л лллл
лл лл   л л ллл   лллл лллллл  л
лл лл ллл л л лл л   л  л     лл
л             л  л лллл   ллл  л
л л лллллллллллл л      л   лллл
л л лллл     ллл   лллл л л    л
л л      ллл     л л  л л лл л л
ллл лл л   ллл л л лл л л  л л л
л   л  л лл  л ллл    л лллл л л
ллл ллл  лл лл    лл лл   л   лл
л      л      л лллллл  л л л  л
лл ллл л лллллл л    л лл л лллл
л    л л      ллл л ллллл л л  л
л лл л лл ллл   л л л    лл л лл
л лл л л    л л   лл  лл лл   лл
л лл лл  л лл л л лл ллл л  л  л
л лл л  лл  л л л    л  лл ллл л
лл   лл   л ллл лл л л ллл л л л
л  л л  л л л   лл л     л   л л
лллл л лл л л л  л ллллллллллллл
лл   л  л л л л лл л   л       л
л  л лл л л л л лл л лл  ллллллл
л лл  л л ллл л лл л лл лл   л л
л  лл л л   л ллл       лл ллл л
лл л лл л л л  л  ллллл     лл л
лл л л  л ллл ллл     ллллл    л
л    лл л    л    л л      лл лл
лллллллллллллллллллллллллллллллл
