████████████████████████████████
█ █     █ █ █ █ █      █ ████ ██
█   █████ █   █   █ ████       █
█ ██    █ █ █ ███ █  █ █ ██ ██ █
█    ████ █ █ █ █ █ ██    █ ████
██ ██   █ █ ███   ████ ██████  █
██ ██ ███ █ █ ██ █   █  █     ██
█             █  █ ████   ███  █
█ █ ████████████ █      █   ████
█ █ ████     ███   ████ █ █    █
█ █      ███     █ █  █ █ ██ █ █
███ ██ █   ███ █ █ ██ █ █  █ █ █
█   █  █ ██  █ ███    █ ████ █ █
███ ███  ██ ██    ██ ██   █   ██
█      █      █ ██████  █ █ █  █
██ ███ █ ██████ █    █ ██ █ ████
█    █ █      ███ █ █████ █ █  █
█ ██ █ ██ ███   █ █ █    ██ █ ██
█ ██ █ █    █ █   ██  ██ ██   ██
█ ██ ██  █ ██ █ █ ██ ███ █  █  █
█ ██ █  ██  █ █ █    █  ██ ███ █
██   ██   █ ███ ██ █ █ ███ █ █ █
█  █ █  █ █ █   ██ █     █   █ █
████ █ ██ █ █ █  █ █████████████
██   █  █ █ █ █ ██ █   █       █
█  █ ██ █ █ █ █ ██ █ ██  ███████
█ ██  █ █ ███ █ ██ █ ██ ██   █ █
█  ██ █ █   █ ███       ██ ███ █
██ █ ██ █ █ █  █  █████     ██ █
██ █ █  █ ███ ███     █████    █
█    ██ █    █    █ █      ██ ██
████████████████████████████████
